15 x 25
*************************
*   R *     ***         *
*     * *     *         *
*                **     *
*   *     *             *
*     *    R R **       *
*   * R *      *        *
***      **          ** *
*              ***      *
*       *   H           *
*   R  **        **     *
*               ***     *
*          *  **  R     *
*   **                  *
*************************